11111
1C001
10001
1P001
11001
10011
11001
10011
11001
10011
11001
1E011
11111