1111111111111
10010000C0001
1000011111001
10000C0000001
1000011100001
1000000000001
1P0011E000001
1111111111111


