11111111111111111
1E00000C0000000C1
10100101001000001
101001001C1010101
1P0000000C00C0001
11111111111111111