1111111111111111111111111111111111
1E1000000000000C00001C100000000001
1010010100100000101010100000010101
1010010010101010001000000000010101
1P0000000C00C0000000000000000001C1
1111111111111111111111111111111111