1111111111111111
1001000000000001
10000111110C0001
1P0011E000000001
1111111111111111