1111111111
1PCE000001
1000000001
111111111E