11111111
1PCE0001
100000011
11111111