1111111111
1PCE000001
1P00000001
1111111111