1111111111
1PC0000001
1000000001
1111111111