11111111
1PCE0001
10001
11111111