1111111111
1PCE000001
10000000001
1111111111