1111111111111111111111111111111111
1E000T000000000C0T000C00T00000C0T1
101001010010T000101001TT0000010101
101T010T10101010001T010T0T00T10101
1P0000000CT0C000T000000000000T00C1
1111111111111111111111111111111111